000 000 000 000 000 000 000 000 000 000
000 103 103 103 103 103 103 103 103 103
000 103 000 000 000 000 000 000 000 000
000 103 000 000 000 000 000 000 000 000
000 103 000 000 000 000 000 000 000 000
000 103 103 103 103 103 103 103 000 000
000 000 000 000 000 000 000 103 000 000
000 000 000 000 000 000 000 103 000 000
103 103 103 103 103 103 103 103 000 000
000 000 000 000 000 000 000 000 000 000