1
0 0 0 0 0 0 0 0 0 0
0 1 1 1 1 1 1 1 1 -1
0 1 0 0 0 0 0 0 0 0
0 1 0 0 0 0 0 0 0 0
0 1 0 0 0 0 0 0 0 0
0 1 1 1 1 1 1 1 0 0
0 0 0 0 0 0 0 1 0 0
0 0 0 0 0 0 0 1 0 0
-2 1 1 1 1 1 1 1 0 0
0 0 0 0 0 0 0 0 0 0
640 640 400
Path
5
512.0 2
256.0 1
384.0 3
192.0 1
640.0 2


