079 080 080 080 080 080 080 080 080 080
102 103 103 103 103 103 103 103 103 103
102 103 082 126 126 126 126 126 126 126
102 103 104 000 000 000 000 000 000 000
102 103 105 080 080 080 080 080 081 000
102 103 103 103 103 103 103 103 104 000
125 126 126 126 126 126 083 103 104 000
080 080 080 080 080 080 106 103 104 000
103 103 103 103 103 103 103 103 104 000
126 126 126 126 126 126 126 126 127 000